1111111111111
1111000000001
10C0011110111
1P10111E00111
1111111111111