1111111111111
1111111111111
111C111111111
111EP11111111
1111111111111