11111111111111111111111111111
1EX00000000000XC0000XC00000X1
10100101001000001010010001101
10100100101010100010010001101
1P0000000C00C0000X000000000C1
11111111111111111111111111111