1111111111111
1111111111111
111C111111111
111EPX1111111
1111111111111