111111111111111
11110000000CX11
11100X1C1100111
10001111100X111
1C0110XEC011111
1X011C10000CX11
11P1X0101101111
11110C00110C111
111111111111111