1111111111111
11110000000C1
1C00011111011
1PCX111E00001
1111111111111